EGE = "countries/EasternGermany.txt"
NGE = "countries/NorthernGermany.txt"
WGE = "countries/WesternGermany.txt"
BNE = "countries/Benelux.txt"
NFR = "countries/NorthernFrance.txt"
WFR = "countries/WesternFrance.txt"
SFR = "countries/SouthernFrance.txt"
ALP = "countries/Alpine.txt"
CZE = "countries/Czechoslovakia.txt"
WPO = "countries/WesternPoland.txt"
EPO = "countries/EasternPoland.txt"
GDB = "countries/GrandDuchyofBalticStates.txt"
NBA = "countries/NorthernBalkans.txt"
EBA = "countries/EasternBalkans.txt"
WBA = "countries/WesternBalkans.txt"
CTL = "countries/Catalon.txt"
BRZ = "countries/Brazil.txt"
AMA = "countries/Amazonas.txt"
HEL = "countries/Hellas.txt"
GGL = "countries/Galicia.txt"
GRA = "countries/Grand Colombia.txt"
GRP = "countries/GreaterPeru.txt"
ARG = "countries/Argentina.txt"
SIS = "countries/SouthernIberia.txt"
TRK = "countries/Turkey.txt"
AAS = "countries/AssociationofArabStates.txt"
CAA = "countries/CentralAmerica.txt"
YUP = "countries/YucatanPeninsula.txt"
NMS = "countries/NorthernMexicanState.txt"
POF = "countries/Porfiriato.txt"
GRC = "countires/GreaterCalifornia.txt"
URC = "countries/UnionOfRockyStates.txt"
<<<<<<< Updated upstream
CUT = "countries/CentralAmericanStates.txt"
GST = "countries/GreaterStateOfTexas.txt"
GLC = "countries/GreatLakesConfederacy.txt"
THC = "countries/ThirteenColonies.txt"
=======
ARA = "countries/Arabia.txt"
>>>>>>> Stashed changes

